10 10
300,000,2 300,000,2 300,000,2 300,000,2 300,000,2 300,000,2 300,000,2 300,000,2 300,000,2 300,000,2 
300,000,2 100,100,1 100,100,1 100,100,1 100,100,1 100,100,1 100,100,1 100,100,1 100,300,2 300,000,2 
300,000,2 100,100,1 100,300,2 100,100,1 100,100,1 100,100,1 100,100,6 100,100,1 100,100,1 300,000,2 
300,000,2 100,100,1 100,100,1 100,100,1 100,100,1 100,100,1 100,100,1 100,100,1 100,100,1 300,000,2 
300,000,2 100,100,1 100,100,1 100,100,1 100,100,1 100,100,1 100,100,1 100,100,1 100,100,1 300,000,2 
300,000,2 100,100,1 100,100,6 100,100,1 100,100,1 100,300,2 100,100,1 100,100,1 100,100,1 300,000,2 
300,000,2 100,100,1 100,100,1 100,100,1 100,100,1 100,100,1 100,100,1 100,100,1 100,100,1 300,000,2 
300,000,2 000,300,1 000,300,1 100,100,1 100,100,1 100,100,1 100,100,6 100,300,2 100,100,1 300,000,2 
300,000,2 000,300,1 000,300,1 100,100,1 100,100,1 100,100,1 100,100,1 100,100,1 100,100,1 300,000,2 
300,000,2 300,000,2 300,000,2 300,000,2 300,000,2 300,100,19 300,000,2 300,000,2 300,000,2 300,000,2 
