13 9
300,000,2 300,000,2 300,000,2 300,000,2 300,000,2 300,000,2 300,000,2 300,000,2 300,000,2 300,000,2 300,000,2 300,000,2 300,000,2 
300,000,2 100,300,2 100,100,1 100,100,1 100,100,1 000,300,1 1000,100,1 000,300,1 100,100,1 100,100,1 100,100,1 100,300,2 300,000,2 
300,000,2 100,100,1 100,100,1 000,300,1 000,300,1 000,300,1 1000,100,1 000,300,1 000,300,1 000,300,1 100,100,1 100,100,1 300,000,2 
300,000,2 100,100,1 100,100,1 000,300,1 1000,100,1 1000,100,1 1000,100,6 1000,100,1 1000,100,1 000,300,1 100,100,1 100,100,1 300,000,2 
300,000,2 100,100,1 100,100,1 000,300,1 000,300,1 000,300,1 1000,100,1 000,300,1 000,300,1 000,300,1 100,100,1 100,100,1 300,000,2 
300,000,2 100,100,1 100,100,1 100,100,1 100,100,1 000,300,1 1000,100,1 000,300,1 100,100,1 100,100,1 100,100,1 100,100,1 300,000,2 
300,000,2 100,100,1 100,100,6 100,100,1 100,100,1 000,300,1 1000,100,1 000,300,1 100,100,1 100,100,1 100,100,1 100,100,1 300,000,2 
300,000,2 100,300,2 100,100,1 100,100,1 100,100,1 000,300,1 1000,100,1 000,300,1 100,100,1 100,100,1 100,100,1 100,300,2 300,000,2 
300,000,2 300,000,2 300,000,2 300,000,2 300,000,2 300,000,2 300,100,17 300,000,2 300,000,2 300,000,2 300,000,2 300,000,2 300,000,2 
