15 12
300,000,2 300,000,2 300,000,2 300,000,2 300,000,2 300,000,2 300,000,2 300,000,2 300,000,2 300,000,2 300,000,2 300,000,2 300,000,2 300,000,2 300,000,2 
300,000,2 100,100,1 100,100,1 300,000,2 100,100,1 100,100,1 100,100,1 100,100,1 100,100,1 800,200,2 800,200,2 300,000,2 1000,100,1 1000,100,1 300,000,2 
300,000,2 100,100,1 1000,100,6 300,000,2 000,300,1 000,300,1 100,100,1 100,100,1 100,100,1 800,200,2 800,200,2 800,200,2 1000,100,1 1000,100,1 300,000,2 
300,000,2 100,100,1 100,100,1 300,000,2 100,100,1 000,300,1 000,300,1 100,100,1 100,100,1 100,300,2 800,200,2 800,200,2 1000,100,1 1000,100,1 300,000,2 
300,000,2 100,100,1 100,100,1 300,000,2 100,100,1 100,100,1 000,300,1 000,300,1 100,100,1 100,100,1 100,100,6 100,100,1 100,100,1 100,100,1 300,000,2 
300,000,2 900,200,1 300,000,2 300,000,2 1000,100,1 1000,100,1 100,100,1 000,300,1 000,300,1 100,100,1 100,100,1 100,100,1 100,100,1 100,100,1 300,000,2 
300,000,2 900,300,1 300,000,2 300,000,2 1000,100,1 1000,100,1 100,100,1 100,100,1 100,100,1 000,300,1 000,300,1 100,100,1 100,100,1 100,100,1 300,000,2 
300,000,2 900,300,1 100,100,1 100,100,1 100,100,1 100,100,1 100,100,1 100,100,1 100,100,1 100,100,1 100,100,1 100,100,1 100,100,1 100,100,1 300,000,2 
300,000,2 100,100,1 100,100,1 100,100,1 100,100,1 100,100,1 100,100,6 100,100,1 100,100,1 100,100,1 100,100,1 100,300,2 100,300,2 100,100,1 300,000,2 
300,000,2 100,100,1 1000,100,1 100,100,1 100,100,1 100,100,1 100,100,1 100,100,1 100,100,1 100,100,1 100,100,1 100,300,2 100,300,2 100,100,1 300,000,2 
300,000,2 100,100,1 100,100,1 1000,100,1 100,100,1 100,100,1 100,100,1 100,100,1 100,100,1 100,100,1 100,100,1 100,100,1 100,100,1 100,100,1 300,000,2 
300,000,2 300,000,2 300,000,2 300,000,2 300,000,2 300,000,2 300,000,2 300,100,15 300,000,2 300,000,2 300,000,2 300,000,2 300,000,2 300,000,2 300,000,2 
