25 25
,0,2 0,0,2 0,0,2 0,0,2 0,0,2 0,0,2 0,0,2 0,0,2 0,0,2 0,0,2 0,0,2 0,0,2 0,0,2 0,0,2 0,0,2 0,0,2 0,0,2 0,0,2 0,0,2 0,0,2 0,0,2 0,0,2 0,0,2 0,0,2 0,0,2 
0,0,2 800,200,1 800,200,1 800,200,1 800,200,1 800,200,1 800,200,1 800,200,1 800,200,1 800,200,1 800,200,1 800,200,1 800,200,2 500,200,13 500,200,13 800,200,2 800,200,2 800,200,2 800,200,2 800,200,2 800,200,2 800,200,2 800,200,2 800,200,2 0,0,2 
0,0,2 800,200,1 800,200,1 800,200,1 800,200,1 800,200,1 800,200,1 800,200,1 800,200,1 800,200,1 800,200,1 800,200,1 800,200,2 500,200,1 500,200,1 800,200,2 800,200,2 800,200,2 800,200,2 800,200,2 800,200,2 800,200,2 800,200,2 800,200,2 0,0,2 
0,0,2 700,100,2 700,100,2 700,100,2 700,100,2 700,100,2 700,100,2 700,100,2 700,100,2 700,100,2 700,100,2 700,100,2 700,100,2 500,200,1 500,200,6 700,100,2 700,100,2 700,100,2 700,100,2 700,100,2 700,100,2 700,100,2 700,100,2 700,100,2 0,0,2 
0,0,2 100,100,1 100,100,1 100,100,1 100,100,1 100,100,1 100,100,1 100,100,1 100,100,6 100,100,1 100,100,1 100,100,1 100,100,1 1000,100,1 1000,100,1 100,100,1 100,100,1 100,100,1 100,100,1 100,100,1 100,100,1 100,100,1 100,100,1 100,100,1 0,0,2 
0,0,2 100,100,1 100,100,1 000,300,1 100,100,1 200,300,2 100,100,1 100,100,1 100,100,1 100,100,1 100,100,1 100,100,1 100,100,1 1000,100,1 1000,100,1 100,100,1 100,100,1 000,300,1 000,300,1 100,100,1 100,100,1 100,100,1 200,300,2 100,100,1 0,0,2 
0,0,2 100,100,26 100,100,1 100,100,1 100,100,1 100,100,1 100,100,1 100,300,2 100,100,1 200,300,2 100,100,1 100,100,1 100,100,1 1000,100,1 1000,100,1 100,100,1 100,100,1 000,300,1 000,300,1 000,300,1 000,300,1 100,100,1 100,100,1 100,100,1 0,0,2 
0,0,2 100,100,1 000,300,1 000,300,1 100,100,1 300,000,2 300,000,2 300,000,2 100,100,1 000,300,1 100,100,1 100,100,1 100,100,1 1000,100,1 1000,100,1 100,100,1 100,100,1 000,300,1 100,100,1 100,100,1 000,300,1 100,100,1 100,100,1 100,100,1 0,0,2 
0,0,2 100,100,1 000,300,1 000,300,1 100,100,26 300,000,2 300,100,18 300,000,2 100,100,1 000,300,1 100,100,1 100,100,1 100,100,1 1000,100,1 1000,100,1 100,100,1 100,100,1 100,100,1 100,100,1 000,300,1 000,300,1 100,100,1 100,100,1 100,100,1 0,0,2 
0,0,2 100,100,1 100,100,1 100,100,1 100,100,1 100,100,1 100,100,1 100,100,1 100,100,1 000,300,1 000,300,1 100,100,1 100,100,1 1000,100,1 1000,100,1 100,100,1 100,100,1 100,100,1 100,100,1 000,300,1 000,300,1 000,300,1 100,100,1 100,100,1 0,0,2 
0,0,2 100,100,1 100,100,1 100,100,1 100,100,1 100,100,1 100,100,6 100,100,1 100,100,1 100,100,1 000,300,1 100,100,1 100,100,26 1000,100,1 1000,100,1 100,100,1 200,300,2 100,100,1 100,100,1 000,300,1 000,300,1 000,300,1 100,100,1 100,100,1 0,0,2 
0,0,2 100,100,1 100,100,1 100,100,1 100,100,1 100,100,1 100,100,1 100,100,1 100,100,1 100,100,1 000,300,1 100,300,2 100,300,2 1000,100,1 1000,100,1 100,100,1 100,100,1 100,100,1 100,100,1 100,100,1 000,300,1 100,100,1 100,100,1 100,100,1 0,0,2 
0,0,2 100,100,1 100,100,1 000,300,1 000,300,1 100,100,1 100,100,1 100,100,1 100,100,1 100,100,1 100,100,1 100,100,1 100,100,1 1000,100,1 1000,100,1 100,100,1 100,100,1 100,100,1 100,100,1 100,100,1 000,300,1 100,100,1 100,100,1 100,100,1 0,0,2 
0,0,2 100,100,1 100,100,1 100,100,1 100,100,1 100,100,1 200,300,2 100,100,1 100,100,1 100,100,1 100,100,1 100,100,1 100,100,1 1000,100,1 1000,100,1 100,100,1 100,100,1 100,100,1 100,100,1 100,100,1 100,100,1 100,100,1 100,100,1 100,100,1 0,0,2 
0,0,2 100,100,1 100,100,1 100,100,1 100,100,1 100,100,1 100,100,1 100,100,1 100,100,1 100,100,1 100,100,1 100,100,1 100,100,1 1000,100,1 1000,100,1 100,100,1 200,300,2 100,100,1 100,100,1 100,100,1 100,100,6 100,100,1 100,100,1 100,100,1 0,0,2 
0,0,2 1000,100,11 1000,100,1 1000,100,1 1000,100,6 1000,100,1 1000,100,1 1000,100,1 1000,100,1 1000,100,1 1000,100,1 1000,100,1 1000,100,1 1000,100,1 1000,100,1 100,100,1 100,100,1 100,100,1 100,100,1 100,100,1 100,100,1 100,100,1 100,100,25 100,100,1 0,0,2 
0,0,2 1000,100,11 1000,100,1 1000,100,1 1000,100,1 1000,100,1 1000,100,1 1000,100,1 1000,100,1 1000,100,1 1000,100,1 1000,100,1 1000,100,1 1000,100,1 1000,100,6 100,100,1 100,100,1 100,100,1 100,100,1 100,100,1 100,100,1 100,100,1 100,100,1 100,100,1 0,0,2 
0,0,2 100,100,1 100,100,1 100,100,1 100,100,1 100,100,1 100,100,1 100,100,1 100,100,1 100,100,1 100,100,1 100,100,1 100,100,1 1000,100,1 1000,100,1 100,100,1 100,100,1 100,100,1 100,100,1 000,300,1 100,100,1 200,300,2 100,100,1 100,100,1 0,0,2 
0,0,2 100,100,1 100,100,1 100,100,1 100,100,1 100,100,1 100,100,1 000,300,1 100,100,1 100,100,1 100,100,1 100,100,1 100,100,1 1000,100,1 1000,100,1 100,100,1 100,100,1 100,100,1 000,300,1 000,300,1 000,300,1 100,100,1 100,100,1 100,100,1 0,0,2 
0,0,2 100,100,1 100,100,1 000,300,1 000,300,1 000,300,1 000,300,1 000,300,1 100,100,1 100,100,1 100,100,1 100,100,1 100,100,1 1000,100,1 1000,100,1 100,100,1 100,100,1 000,300,1 000,300,1 000,300,1 000,300,1 100,100,1 100,100,1 100,100,1 0,0,2 
0,0,2 100,100,1 100,100,1 000,300,1 000,300,1 100,100,1 100,100,1 000,300,1 100,100,1 100,100,1 100,100,1 200,300,2 100,100,1 1000,100,1 1000,100,1 100,100,1 100,100,26 000,300,1 100,100,1 100,100,1 000,300,1 100,100,1 100,100,1 100,100,1 0,0,2 
0,0,2 100,100,1 100,100,1 100,100,1 100,100,1 200,300,2 100,100,1 000,300,1 100,100,1 100,100,1 100,100,1 100,100,1 100,100,1 1000,100,1 1000,100,1 100,100,1 100,100,1 100,100,1 100,100,1 100,100,1 000,300,1 000,300,1 100,100,1 100,100,1 0,0,2 
0,0,2 100,100,1 100,100,1 100,100,1 100,100,1 100,100,1 100,100,1 100,100,1 100,100,1 100,300,2 100,100,1 100,100,1 100,100,1 1000,100,1 1000,100,1 100,100,1 100,100,1 100,100,1 100,100,6 100,100,1 100,100,1 100,100,1 100,300,2 100,300,2 0,0,2 
0,0,2 100,100,1 100,100,1 100,100,1 100,100,1 100,100,1 100,100,1 100,100,1 100,100,1 100,100,1 100,100,1 100,100,1 100,100,20 1000,100,20 1000,100,1 100,100,1 100,100,1 100,100,1 100,100,1 100,100,1 100,100,1 100,100,1 100,300,2 100,300,2 0,0,2 
0,0,2 0,0,2 0,0,2 0,0,2 0,0,2 0,0,2 0,0,2 0,0,2 0,0,2 0,0,2 0,0,2 0,0,2 0,0,2 0,0,2 0,0,2 0,0,2 0,0,2 0,0,2 0,0,2 0,0,2 0,0,2 0,0,2 0,0,2 0,0,2 0,0,2 
