25 25
100,0,2 100,0,2 100,0,2 100,0,2 100,0,2 100,0,2 100,0,2 100,0,2 100,0,2 100,0,2 100,0,2 100,0,2 100,0,2 100,0,21 100,0,21 100,0,2 100,0,2 100,0,2 100,0,2 100,0,2 100,0,2 100,0,2 100,0,2 100,0,2 100,0,2 
100,0,2 100,100,1 100,100,1 100,100,1 100,100,1 100,100,1 100,100,1 100,100,1 100,100,1 000,300,1 000,300,1 100,100,1 100,100,1 1000,100,1 1000,100,1 100,100,1 100,300,2 100,100,1 100,100,1 100,100,1 100,100,1 100,100,1 100,100,1 100,100,1 100,0,2 
100,0,2 100,100,1 100,100,1 100,100,1 100,100,1 200,300,2 100,100,1 100,100,1 100,100,1 000,300,1 000,300,1 100,100,1 100,100,1 1000,100,1 1000,100,1 000,300,1 000,300,1 000,300,1 000,300,1 100,100,1 100,100,1 100,100,1 100,300,2 100,100,1 100,0,2 
100,0,2 100,100,1 1000,100,1 1000,100,1 1000,100,1 1000,100,1 1000,100,1 1000,100,1 1000,100,6 1000,100,1 1000,100,1 1000,100,1 1000,100,1 1000,100,1 1000,100,1 1000,100,1 1000,100,1 1000,100,1 1000,100,1 1000,100,1 1000,100,1 1000,100,1 1000,100,1 100,100,1 100,0,2 
100,0,2 100,100,1 1000,100,1 1000,100,1 1000,100,1 1000,100,1 1000,100,1 1000,100,1 1000,100,1 1000,100,1 1000,100,1 1000,100,1 1000,100,1 1000,100,1 1000,100,1 1000,100,1 1000,100,1 1000,100,1 1000,100,1 1000,100,1 1000,100,1 1000,100,1 1000,100,1 100,100,1 100,0,2 
100,0,2 100,100,1 1000,100,1 1000,100,1 100,100,1 100,100,1 100,100,1 100,100,1 100,100,1 100,100,1 100,100,1 000,300,1 000,300,1 000,300,1 000,300,1 100,100,1 100,100,1 100,100,1 100,100,1 100,100,1 100,100,1 1000,100,1 1000,100,1 100,100,1 100,0,2 
100,0,2 100,100,1 1000,100,1 1000,100,1 100,100,1 300,000,2 300,000,2 300,000,2 300,000,2 300,000,2 300,000,2 300,000,2 300,000,2 300,000,2 300,000,2 300,000,2 300,000,2 300,000,2 300,000,2 300,000,2 100,100,1 1000,100,1 1000,100,1 100,100,1 100,0,2 
100,0,2 100,100,1 1000,100,1 1000,100,1 100,100,1 300,000,2 100,100,1 100,100,1 100,100,1 100,100,1 000,300,1 000,300,1 000,300,1 000,300,1 100,100,1 100,100,1 100,100,1 100,100,1 100,100,1 300,000,2 100,100,1 1000,100,1 1000,100,1 100,100,1 100,0,2 
100,0,2 100,100,1 1000,100,1 1000,100,1 100,100,1 300,000,2 100,100,1 300,000,2 300,000,2 300,000,2 300,000,2 300,000,2 300,000,2 300,000,2 300,000,2 300,000,2 300,000,2 300,000,2 100,100,1 300,000,2 100,100,1 1000,100,1 1000,100,1 100,100,1 100,0,2 
100,0,2 100,100,1 1000,100,1 1000,100,1 100,100,1 300,000,2 100,100,1 300,000,2 100,100,1 100,100,1 100,100,1 100,100,1 100,100,1 100,100,1 100,100,1 100,100,1 100,100,1 300,000,2 100,100,1 300,000,2 100,100,1 1000,100,1 1000,100,1 100,100,1 100,0,2 
100,0,2 100,100,1 1000,100,1 1000,100,1 000,300,1 300,000,2 100,100,1 300,000,2 100,100,1 300,000,2 300,000,2 300,000,2 300,000,2 300,000,2 300,000,2 300,000,2 100,100,1 300,000,2 100,100,1 300,000,2 100,100,1 1000,100,1 1000,100,1 200,300,2 100,0,2 
100,0,2 100,100,1 1000,100,1 1000,100,1 000,300,1 300,000,2 100,100,1 300,000,2 100,100,1 300,000,2 100,300,2 100,100,1 100,100,1 000,300,1 000,300,1 300,000,2 100,100,1 300,000,2 100,100,1 300,000,2 100,100,1 1000,100,1 1000,100,1 100,100,1 100,0,2 
100,0,2 100,100,1 1000,100,1 1000,100,1 000,300,1 300,000,2 100,100,6 300,000,2 100,100,1 300,000,2 100,100,1 100,100,1 100,100,22 100,100,1 100,100,1 300,000,2 000,300,1 300,000,2 100,100,1 300,000,2 100,100,1 1000,100,1 1000,100,1 100,100,1 100,0,2 
100,0,2 000,300,1 1000,100,1 1000,100,1 000,300,1 300,000,2 100,100,1 300,000,2 100,100,1 300,000,2 100,100,1 100,100,1 100,100,1 100,100,1 100,100,1 300,000,2 000,300,1 300,000,2 100,100,1 300,000,2 100,100,1 1000,100,1 1000,100,1 100,100,1 100,0,2 
100,0,2 100,100,1 1000,100,1 1000,100,1 100,100,1 300,000,2 100,100,1 300,000,2 100,100,1 300,000,2 300,000,2 900,300,1 300,000,2 300,000,2 300,000,2 300,000,2 000,300,1 300,000,2 100,100,1 300,000,2 000,300,1 1000,100,1 1000,100,1 100,100,1 100,0,2 
100,0,2 100,100,1 1000,100,6 1000,100,1 200,300,2 300,000,2 100,100,1 300,000,2 100,100,1 100,100,1 000,300,1 000,300,1 100,100,1 300,000,2 100,100,1 100,100,1 100,100,1 300,000,2 100,100,1 300,000,2 000,300,1 1000,100,1 1000,100,1 000,300,1 100,0,2 
100,0,2 100,100,1 1000,100,1 1000,100,1 100,100,1 300,000,2 100,100,1 300,000,2 300,000,2 300,000,2 300,000,2 300,000,2 300,000,2 300,000,2 900,300,1 300,000,2 300,000,2 300,000,2 100,100,1 300,000,2 000,300,1 1000,100,1 1000,100,1 000,300,1 100,0,2 
100,0,2 100,100,1 1000,100,1 1000,100,1 100,100,1 300,000,2 000,300,1 000,300,1 000,300,1 100,100,1 100,100,1 100,100,1 100,100,1 300,000,2 100,100,1 100,100,1 100,100,1 100,100,1 100,100,1 300,000,2 000,300,1 1000,100,1 1000,100,1 000,300,1 100,0,2 
100,0,2 100,100,1 1000,100,1 1000,100,1 100,100,1 300,000,2 300,000,2 300,000,2 300,000,2 300,000,2 300,000,2 300,000,2 900,300,1 300,000,2 300,000,2 300,000,2 300,000,2 300,000,2 300,000,2 300,000,2 100,100,1 1000,100,6 1000,100,1 000,300,1 100,0,2 
100,0,2 100,100,1 1000,100,1 1000,100,1 100,100,1 100,100,1 100,100,1 100,100,1 100,100,1 100,100,1 100,100,1 1000,100,1 1000,100,6 1000,100,1 100,100,1 100,100,1 100,100,1 100,300,2 100,100,1 100,100,1 100,100,1 1000,100,1 1000,100,1 000,300,1 100,0,2 
100,0,2 100,100,1 1000,100,1 1000,100,1 100,100,1 100,100,1 100,100,1 100,100,1 100,100,1 100,100,1 100,100,1 1000,100,1 1000,100,1 1000,100,1 100,100,1 100,100,1 100,100,1 100,100,1 100,100,1 100,100,1 100,100,1 1000,100,1 1000,100,1 100,100,1 100,0,2 
100,0,2 100,100,1 1000,100,1 1000,100,1 1000,100,1 1000,100,1 1000,100,1 1000,100,1 1000,100,1 1000,100,1 1000,100,1 1000,100,1 1000,100,1 1000,100,1 1000,100,1 1000,100,1 1000,100,1 1000,100,1 1000,100,1 1000,100,1 1000,100,1 1000,100,1 1000,100,1 100,100,1 100,0,2 
100,0,2 100,100,1 1000,100,1 1000,100,1 1000,100,1 1000,100,1 1000,100,1 1000,100,1 1000,100,1 1000,100,1 1000,100,1 1000,100,1 1000,100,1 1000,100,1 1000,100,1 1000,100,1 1000,100,1 1000,100,1 1000,100,1 1000,100,1 1000,100,1 1000,100,1 1000,100,1 100,100,1 100,0,2 
100,0,2 200,300,2 100,100,1 100,100,1 100,100,1 100,100,1 100,100,1 100,100,1 100,100,1 100,100,1 100,100,1 100,100,1 100,100,1 100,100,1 100,100,1 100,100,1 100,100,1 100,100,1 100,100,1 100,100,1 100,300,2 100,100,1 100,100,1 100,100,1 100,0,2 
100,0,2 100,0,2 100,0,2 100,0,2 100,0,2 100,0,2 100,0,2 100,0,2 100,0,2 100,0,2 100,0,2 100,0,2 100,0,2 100,0,2 100,0,2 100,0,2 100,0,2 100,0,2 100,0,2 100,0,2 100,0,2 100,0,2 100,0,2 100,0,2 100,0,2 
