25 25
0,000,2 0,000,2 0,000,2 0,000,2 0,000,2 0,000,2 0,000,2 0,000,2 0,000,2 0,000,2 0,000,2 0,000,2 0,000,2 0,000,2 0,000,2 0,000,2 0,000,2 0,000,2 0,000,2 0,000,2 0,000,2 0,000,2 0,000,2 0,000,2 0,000,2 
0,000,2 100,100,1 100,100,1 100,100,1 100,100,1 100,100,1 100,100,1 100,100,1 100,100,1 100,100,1 100,100,1 100,100,1 100,100,1 100,100,1 100,100,1 100,100,1 100,100,1 300,000,2 300,000,2 300,000,2 300,000,2 300,000,2 300,000,2 300,000,2 0,000,2 
0,000,2 100,100,1 100,100,1 100,100,1 100,100,1 100,100,1 200,300,2 100,100,1 100,100,1 100,100,1 100,300,2 100,100,1 100,100,1 100,100,1 100,100,1 100,100,1 100,100,1 300,000,2 100,100,1 100,300,2 300,000,2 300,000,2 300,000,2 300,000,2 0,000,2 
0,000,2 500,000,2 500,000,2 500,000,2 500,000,2 500,000,2 500,000,2 500,100,2 100,100,1 100,100,1 100,100,1 100,100,1 100,100,1 200,300,2 100,100,1 100,100,1 100,100,1 300,000,2 100,100,6 100,100,1 600,000,2 300,000,2 300,000,2 300,000,2 0,000,2 
0,000,2 1000,100,9 1000,100,1 1000,100,1 1000,100,1 1000,100,1 1000,100,1 300,300,2 100,100,1 100,100,1 100,100,1 100,100,1 100,100,1 100,100,1 200,300,2 100,100,1 100,100,1 300,000,2 300,000,2 900,200,1 300,000,2 300,000,2 300,000,2 300,000,2 0,000,2 
0,000,2 1000,100,9 1000,100,1 1000,100,1 1000,100,1 1000,100,1 1000,100,1 400,200,2 500,000,2 500,000,2 500,000,2 500,000,2 500,000,2 500,100,2 100,100,1 100,100,1 100,100,1 300,000,2 600,000,2 900,200,1 300,000,2 300,000,2 600,000,2 300,000,2 0,000,2 
0,000,2 100,100,1 100,100,1 100,100,1 100,100,1 1000,100,1 1000,100,6 1000,100,26 1000,100,1 1000,100,1 1000,100,1 1000,100,1 1000,100,1 300,300,2 100,100,1 100,100,1 100,100,1 300,000,2 300,000,2 900,300,1 300,100,16 300,100,16 300,000,2 300,000,2 0,000,2 
0,000,2 100,100,1 100,100,1 100,100,1 100,100,1 1000,100,1 1000,100,1 1000,100,1 1000,100,1 1000,100,1 1000,100,1 1000,100,1 1000,100,1 300,300,2 100,100,1 100,100,1 100,100,1 100,100,1 100,100,1 100,100,1 1000,100,1 1000,100,1 100,100,1 100,100,1 0,000,2 
0,000,2 100,100,1 100,100,1 100,100,1 100,100,1 100,100,1 100,100,1 100,100,1 100,100,1 100,100,1 100,100,1 1000,100,1 1000,100,1 400,200,2 100,100,1 100,100,1 100,100,1 100,100,1 100,100,1 100,100,1 1000,100,1 1000,100,1 100,100,1 100,100,1 0,000,2 
0,000,2 100,100,1 100,100,1 000,300,1 100,100,1 100,100,1 000,300,1 000,300,1 100,100,1 100,100,1 100,100,1 1000,100,1 1000,100,1 1000,100,1 1000,100,1 100,100,1 100,100,1 100,100,1 100,100,1 100,100,1 1000,100,1 1000,100,6 100,100,1 100,100,1 0,000,2 
0,000,2 100,100,1 100,300,1 000,300,1 100,100,1 100,100,1 000,300,1 000,300,1 100,100,1 100,100,1 100,100,1 1000,100,1 1000,100,1 1000,100,1 1000,100,1 100,100,1 100,100,1 100,100,1 100,100,1 100,100,1 1000,100,1 1000,100,1 100,100,1 100,100,1 0,000,2 
0,000,2 100,100,1 100,100,1 000,300,1 100,100,1 000,300,1 000,300,1 000,300,1 100,100,1 100,100,1 100,100,1 100,100,1 100,100,1 1000,100,1 1000,100,1 1000,100,1 1000,100,1 1000,100,1 1000,100,1 1000,100,1 1000,100,1 1000,100,1 100,100,1 100,100,1 0,000,2 
0,000,2 100,100,1 100,100,26 000,300,1 100,100,1 000,300,1 100,100,1 000,300,1 100,100,1 100,100,1 100,100,1 100,100,1 100,100,1 1000,100,6 1000,100,1 1000,100,1 1000,100,1 1000,100,1 1000,100,1 1000,100,1 1000,100,1 1000,100,1 100,100,1 100,100,1 0,000,2 
0,000,2 100,100,1 100,100,1 000,300,1 000,300,1 000,300,1 000,300,1 100,100,1 100,100,1 100,100,1 100,100,1 100,100,1 100,100,1 1000,100,1 1000,100,1 100,100,1 100,100,1 100,100,1 100,100,1 100,100,1 100,100,1 100,100,1 100,100,1 100,100,1 0,000,2 
0,000,2 100,100,1 100,100,6 100,100,1 000,300,1 000,300,1 000,300,1 100,100,1 100,100,1 000,300,1 000,300,1 100,100,1 100,100,1 1000,100,1 1000,100,1 100,100,1 100,300,2 100,300,2 100,100,1 100,100,1 100,100,1 100,100,1 100,100,1 100,100,1 0,000,2 
0,000,2 100,100,1 100,100,1 100,100,1 000,300,1 000,300,1 000,300,1 000,300,26 000,300,1 000,300,1 000,300,1 000,300,1 100,100,1 1000,100,1 1000,100,1 100,100,1 100,300,2 100,300,2 100,100,1 100,100,1 100,100,1 000,300,1 100,100,1 100,100,1 0,000,2 
0,000,2 100,100,1 100,100,1 100,100,1 000,300,1 000,300,1 200,300,2 100,100,1 100,100,1 100,100,1 100,100,1 000,300,1 100,100,1 1000,100,1 1000,100,1 100,100,1 100,100,1 100,100,1 100,100,1 100,100,1 100,100,1 000,300,1 100,100,1 100,100,1 0,000,2 
0,000,2 100,100,1 100,100,1 100,100,1 100,100,1 100,100,1 100,100,1 100,100,1 100,100,1 100,100,1 100,100,1 100,100,1 100,100,1 1000,100,1 1000,100,1 100,100,1 100,100,1 100,100,1 100,100,1 100,100,1 100,100,1 200,300,2 000,300,1 000,300,1 0,000,2 
0,000,2 100,100,1 100,100,25 100,100,1 100,100,1 100,100,1 100,100,1 100,100,1 100,100,1 100,100,1 100,100,1 100,100,1 100,100,1 1000,100,1 1000,100,1 100,100,1 100,100,1 100,100,1 100,100,1 100,100,6 100,100,1 000,300,1 000,300,1 000,300,1 0,000,2 
0,000,2 100,100,1 100,100,1 100,100,1 100,100,1 100,100,1 100,100,1 100,100,1 100,100,1 100,100,1 100,100,1 100,100,1 100,100,1 1000,100,1 1000,100,1 100,100,1 100,100,1 100,100,1 100,100,1 100,100,1 100,100,1 100,100,1 000,300,1 100,100,1 0,000,2 
0,000,2 600,200,2 600,200,2 600,200,2 600,200,2 600,200,2 600,200,2 600,200,2 600,200,2 600,200,2 600,200,2 600,200,2 600,200,2 500,200,1 500,200,1 600,200,2 600,200,2 600,200,2 600,200,2 600,200,2 600,200,2 600,200,2 600,200,2 600,200,2 0,000,2 
0,000,2 800,200,1 800,200,1 800,200,1 800,200,1 800,200,1 800,200,1 800,200,1 800,200,1 800,200,1 800,200,1 800,200,1 800,200,2 500,200,1 500,200,1 800,200,2 800,200,1 800,200,1 800,200,1 800,200,1 800,200,1 800,200,1 800,200,1 800,200,1 0,000,2 
0,000,2 800,200,1 800,200,1 800,200,1 800,200,1 800,200,1 800,200,1 800,200,1 800,200,1 800,200,1 800,200,1 800,200,1 800,200,2 500,200,1 500,200,1 800,200,2 800,200,1 800,200,1 800,200,1 800,200,1 800,200,1 800,200,1 800,200,1 800,200,1 0,000,2 
0,000,2 800,200,1 800,200,1 800,200,1 800,200,1 800,200,1 800,200,1 800,200,1 800,200,1 800,200,1 800,200,1 800,200,1 800,200,2 500,200,12 500,200,12 800,200,2 800,200,1 800,200,1 800,200,1 800,200,1 800,200,1 800,200,1 800,200,1 800,200,1 0,000,2 
0,000,2 0,000,2 0,000,2 0,000,2 0,000,2 0,000,2 0,000,2 0,000,2 0,000,2 0,000,2 0,000,2 0,000,2 0,000,2 0,000,2 0,000,2 0,000,2 0,000,2 0,000,2 0,000,2 0,000,2 0,000,2 0,000,2 0,000,2 0,000,2 0,000,2 
