50 50
0,000,2 0,000,2 0,000,2 0,000,2 0,000,2 0,000,2 0,000,2 0,000,2 0,000,2 0,000,2 0,000,2 0,000,2 0,000,2 0,000,2 0,000,2 0,000,2 0,000,2 0,000,2 0,000,2 0,000,2 0,000,2 0,000,2 0,000,2 0,000,2 0,000,2 0,000,2 0,000,2 0,000,2 0,000,2 0,000,2 0,000,2 0,000,2 0,000,2 0,000,2 0,000,2 0,000,2 0,000,2 0,000,2 0,000,2 0,000,2 0,000,2 0,000,2 0,000,2 0,000,2 0,000,2 0,000,2 0,000,2 0,000,2 0,000,2 0,000,2 
0,000,2 100,100,1 000,300,1 000,300,1 100,100,1 100,100,1 100,100,1 100,100,1 100,100,1 200,300,2 100,100,1 100,100,1 100,100,1 100,100,1 100,100,1 100,100,1 100,100,1 100,100,1 100,100,1 100,100,1 100,100,1 100,100,1 100,100,1 100,100,1 100,100,1 100,100,1 100,100,1 100,100,1 100,100,1 100,100,1 100,100,1 100,100,1 100,100,1 100,100,1 100,100,1 100,100,1 100,100,1 100,100,1 100,100,1 100,100,1 100,100,1 100,100,1 100,100,1 100,100,1 100,100,1 100,100,1 100,100,1 100,100,1 100,100,1 0,000,2 
0,000,2 100,100,1 100,100,1 100,100,1 100,100,1 100,100,1 100,100,1 100,100,1 100,100,1 100,100,1 100,100,1 100,100,1 000,300,1 000,300,1 100,100,1 500,100,2 100,100,1 100,100,1 100,100,1 100,100,1 100,100,1 100,100,1 100,100,1 100,100,1 100,100,1 100,100,1 100,100,1 100,100,1 100,100,1 100,100,1 100,100,1 100,100,1 100,100,1 100,100,1 100,100,1 100,100,1 100,100,1 100,100,1 100,100,1 100,100,1 100,100,1 100,100,1 100,100,1 100,100,1 100,100,1 100,100,1 100,100,1 100,100,1 100,100,1 0,000,2 
0,000,2 100,100,1 100,100,1 100,100,1 100,100,1 100,100,1 1000,200,1 1000,200,1 1000,200,1 1000,200,1 1000,200,1 1000,200,1 1000,200,1 1000,200,1 1000,200,1 300,300,2 100,100,1 100,100,1 100,100,1 100,100,1 000,300,1 000,300,1 000,300,1 000,300,1 000,300,1 000,300,1 000,300,1 000,300,1 000,300,1 100,100,1 100,100,1 100,100,1 100,100,1 000,300,1 000,300,1 000,300,1 100,100,1 100,100,1 100,100,1 100,100,1 300,200,2 500,000,2 500,000,2 500,000,2 500,000,2 500,000,2 500,000,2 500,000,2 500,000,2 0,000,2 
0,000,2 100,100,1 100,100,1 200,300,2 100,100,1 1000,100,1 1000,200,1 1000,200,1 1000,200,1 1000,200,1 1000,200,1 1000,200,1 1000,200,1 1000,200,1 1000,200,1 300,300,2 100,100,1 100,100,1 100,100,1 100,100,1 000,300,1 000,300,1 000,300,1 000,300,1 000,300,1 000,300,1 000,300,1 000,300,1 000,300,1 100,100,1 100,100,1 000,300,1 000,300,1 100,100,1 000,300,1 000,300,1 100,100,1 100,100,1 000,300,1 000,300,1 300,300,2 1000,200,1 1000,200,1 1000,200,1 1000,200,1 1000,200,6 1000,200,8 1000,200,1 1000,200,8 0,000,2 
0,000,2 100,100,1 100,100,1 100,100,1 1000,100,1 1000,100,1 1000,100,1 1000,100,1 1000,100,1 100,100,1 100,100,1 100,100,1 100,100,1 1000,200,1 1000,200,1 300,300,2 100,100,1 100,100,1 100,100,1 100,100,1 100,100,1 100,100,1 100,100,1 100,100,1 100,100,1 100,100,1 100,100,1 100,100,1 100,100,1 100,100,1 000,300,1 000,300,1 100,100,1 100,100,1 100,100,1 100,100,6 100,100,1 100,100,1 100,100,1 000,300,1 300,300,2 1000,200,1 1000,200,1 1000,200,1 1000,200,1 1000,200,1 1000,200,1 1000,200,1 1000,200,8 0,000,2 
0,000,2 100,100,1 100,100,1 1000,100,1 1000,100,1 1000,100,1 1000,100,1 1000,100,1 1000,100,1 1000,100,1 100,100,1 100,100,1 100,100,1 1000,200,1 1000,200,1 300,300,2 200,300,2 100,100,1 100,100,1 100,100,1 100,100,1 100,100,1 100,100,1 100,100,1 100,100,1 100,100,1 100,100,1 100,100,1 100,100,1 100,100,1 100,100,1 100,100,1 100,100,1 200,300,2 100,100,1 100,100,1 100,100,1 100,100,1 100,100,1 100,100,1 300,300,2 1000,200,1 1000,200,1 100,100,1 200,300,2 100,100,1 100,100,1 000,300,0 100,100,1 0,000,2 
0,000,2 100,100,1 100,100,1 100,100,1 1000,100,1 1000,100,1 1000,100,1 1000,100,1 1000,100,1 100,100,1 100,100,1 200,300,2 100,100,1 1000,200,1 1000,200,1 300,300,2 100,100,1 100,100,1 100,100,1 100,100,6 100,100,1 100,100,1 100,100,1 200,300,2 100,100,1 100,100,1 100,100,1 100,100,1 100,100,1 100,100,1 100,100,1 100,100,1 100,100,1 100,100,1 100,100,1 000,300,1 100,100,1 100,100,1 000,300,1 000,300,1 300,300,2 1000,200,1 1000,200,1 100,100,1 100,100,1 100,100,1 100,100,1 000,300,1 100,100,1 0,000,2 
0,000,2 100,100,1 100,100,1 100,100,1 100,100,1 1000,100,1 1000,100,1 1000,100,1 100,100,1 100,100,1 100,100,1 100,100,1 100,100,1 1000,200,1 1000,200,1 300,300,2 100,100,1 100,100,1 100,100,1 100,100,1 100,100,1 100,100,1 100,100,1 100,100,1 100,100,1 000,300,1 100,100,1 100,100,1 100,100,1 000,300,1 100,100,1 100,100,1 000,300,1 000,300,1 100,100,1 000,300,1 100,100,1 000,300,1 000,300,1 100,100,1 300,300,2 1000,200,1 1000,200,1 100,100,1 100,100,1 100,100,1 100,100,1 100,100,1 100,100,1 0,000,2 
0,000,2 100,100,1 100,100,1 200,300,2 000,300,1 100,100,1 1000,100,1 100,100,1 100,100,1 100,100,1 100,100,1 100,100,1 100,100,1 1000,200,1 1000,200,1 400,200,2 500,000,2 500,000,2 500,000,2 500,000,2 500,000,2 500,000,2 500,000,2 500,000,2 500,000,2 500,000,2 500,000,2 500,000,2 500,000,2 500,000,2 500,000,2 500,000,2 500,000,2 500,000,2 500,000,2 500,000,2 500,000,2 500,000,2 500,000,2 500,000,2 400,300,2 1000,200,1 1000,200,1 000,300,1 100,100,1 100,100,1 100,100,1 100,100,1 100,100,1 0,000,2 
0,000,2 100,100,1 100,100,1 100,100,1 000,300,1 100,100,1 100,100,1 100,100,1 100,100,1 100,100,1 100,100,1 100,100,1 100,100,1 1000,200,1 1000,200,1 1000,200,1 1000,200,1 1000,200,1 1000,200,1 1000,200,1 1000,200,1 1000,200,1 1000,200,1 1000,200,1 1000,200,1 1000,200,1 1000,200,1 1000,200,1 1000,200,1 1000,200,1 1000,200,1 1000,200,1 1000,200,1 1000,200,1 1000,200,1 1000,200,1 1000,200,1 1000,200,1 1000,200,1 1000,200,1 1000,200,1 1000,200,1 1000,200,1 000,300,1 100,100,1 100,100,1 100,100,1 100,100,1 100,100,1 0,000,2 
0,000,2 100,100,1 100,100,1 100,100,1 000,300,1 100,100,1 100,100,1 100,100,1 100,100,1 200,300,2 100,100,1 100,100,1 100,100,1 1000,200,1 1000,200,1 1000,200,1 1000,200,1 1000,200,1 1000,200,1 1000,200,1 1000,200,1 1000,200,1 1000,200,1 1000,200,1 1000,200,1 1000,200,1 1000,200,1 1000,200,1 1000,200,1 1000,200,1 1000,200,1 1000,200,1 1000,200,1 1000,200,1 1000,200,1 1000,200,1 1000,200,1 1000,200,1 1000,200,1 1000,200,1 1000,200,1 1000,200,1 1000,200,1 100,100,1 100,100,1 100,100,1 100,100,1 000,300,1 000,300,1 0,000,2 
0,000,2 100,100,1 100,100,1 100,100,1 000,300,1 000,300,1 000,300,1 100,100,1 100,100,1 100,100,1 100,100,1 100,100,1 100,100,1 100,100,1 100,100,1 100,100,1 000,300,1 000,300,1 100,100,1 100,100,1 100,100,1 100,100,1 000,300,1 100,100,1 100,100,1 1000,200,1 1000,200,1 100,100,1 000,300,1 100,100,1 100,100,1 100,100,1 100,100,1 100,100,1 100,100,1 000,300,1 100,100,1 100,100,1 000,300,1 000,300,1 100,100,1 100,100,1 000,300,1 100,100,1 100,100,1 100,100,1 100,100,1 000,300,1 100,100,1 0,000,2 
0,000,2 100,100,1 100,100,1 100,100,1 100,100,1 100,100,1 000,300,1 000,300,1 100,100,1 100,100,1 100,100,1 100,100,1 100,100,1 100,100,1 100,100,1 100,100,1 100,100,1 000,300,1 100,100,1 100,100,1 100,100,1 000,300,1 000,300,1 100,100,1 100,100,1 1000,200,6 1000,200,1 100,100,1 000,300,1 000,300,1 100,100,1 200,300,2 100,100,1 100,100,1 100,100,1 000,300,1 000,300,1 100,100,1 100,100,1 100,100,1 100,100,1 100,100,1 000,300,1 100,100,1 100,100,1 100,100,1 000,300,1 000,300,1 100,100,1 0,000,2 
0,000,2 100,100,1 100,100,1 100,100,1 100,100,1 100,100,1 100,100,1 100,100,1 100,100,1 000,300,1 000,300,1 100,100,1 100,100,1 100,100,1 100,100,26 200,300,2 100,100,1 100,100,1 100,100,1 100,100,1 000,300,1 000,300,1 100,100,1 100,100,1 100,100,1 1000,200,1 1000,200,1 100,100,1 100,100,1 100,100,1 100,100,1 000,300,1 100,100,1 100,100,1 100,100,1 100,100,1 100,100,1 100,100,1 100,100,1 100,100,1 000,300,1 000,300,1 100,100,1 100,100,1 100,100,1 100,100,26 100,100,1 100,100,1 100,100,1 0,000,2 
0,000,2 100,100,1 100,300,2 100,300,2 100,100,1 100,100,1 100,100,1 100,100,1 100,100,1 100,100,1 000,300,1 000,300,1 000,300,6 100,100,1 100,100,1 100,100,1 100,100,1 100,100,1 100,100,1 000,300,1 000,300,1 100,100,1 100,100,1 100,100,1 100,100,1 1000,200,1 1000,200,1 100,100,1 100,100,1 100,100,1 100,100,1 100,100,1 100,100,1 100,100,1 100,100,1 000,300,1 100,100,1 100,100,1 100,100,1 000,300,1 000,300,1 100,100,1 200,300,2 100,100,1 100,100,1 000,300,1 100,100,1 100,100,1 100,100,1 0,000,2 
0,000,2 100,100,1 100,300,2 100,300,2 100,100,1 100,100,1 100,100,1 100,100,1 100,100,1 100,100,1 100,100,1 100,100,1 100,100,1 000,300,1 000,300,1 100,100,1 100,100,1 100,100,1 000,300,1 000,300,1 100,100,1 100,100,1 100,100,1 100,100,1 100,100,1 1000,200,1 1000,200,1 100,100,1 100,100,1 100,100,1 100,100,1 100,100,1 100,100,1 100,100,1 100,100,1 100,100,1 000,300,1 000,300,1 000,300,1 100,100,1 100,100,1 100,100,1 100,100,1 100,100,1 000,300,1 000,300,1 100,100,1 100,100,1 100,100,1 0,000,2 
0,000,2 100,100,1 100,100,1 100,100,1 100,100,1 100,100,1 100,100,1 100,100,1 100,100,1 200,300,2 100,100,1 100,100,1 100,100,1 100,100,1 100,100,1 100,100,1 100,100,1 100,100,1 100,100,1 100,100,1 100,300,2 100,100,1 100,100,1 100,100,1 100,100,1 1000,200,1 1000,200,1 100,100,1 100,100,1 100,100,1 100,100,1 100,100,1 100,300,2 100,300,2 100,100,1 100,100,1 100,100,1 100,100,1 100,100,1 100,100,1 100,100,1 100,100,1 100,100,1 100,100,1 100,100,1 100,100,1 100,100,1 100,100,1 100,100,1 0,000,2 
0,000,2 100,100,1 100,100,1 100,100,1 100,100,1 100,100,1 100,100,1 100,100,1 100,100,1 100,100,1 100,100,1 100,100,1 100,100,1 100,100,1 100,100,1 100,100,1 100,100,1 100,100,1 200,300,2 100,100,1 100,300,2 100,100,1 100,100,1 100,100,1 100,100,1 1000,200,1 1000,200,1 100,100,1 100,100,1 100,100,1 100,100,1 100,100,1 100,300,2 100,300,2 100,100,1 100,100,1 100,100,1 100,100,1 100,100,1 100,100,1 100,100,1 100,100,1 100,100,1 100,100,1 100,100,1 100,100,1 100,100,1 100,100,1 100,100,1 0,000,2 
0,000,2 100,100,1 100,100,1 100,100,1 100,100,1 100,100,1 100,100,1 100,100,1 100,100,1 100,100,1 100,100,1 100,100,1 100,100,1 100,100,1 100,100,1 100,100,1 100,100,1 100,100,1 100,100,1 100,100,1 100,100,1 100,100,1 100,100,1 100,100,1 100,100,1 1000,200,1 1000,200,1 100,100,1 100,100,1 100,100,1 100,100,1 100,100,1 100,100,1 100,100,1 100,100,1 100,100,1 100,100,1 100,100,1 100,100,1 100,100,1 100,100,1 100,100,1 100,100,1 100,100,1 100,100,1 100,100,1 100,100,1 100,100,1 100,100,1 0,000,2 
0,000,2 100,100,1 100,100,1 100,100,1 100,100,1 100,100,1 100,100,1 100,100,1 100,100,1 100,100,1 100,100,1 100,100,1 100,100,1 100,100,1 100,100,1 100,100,1 100,100,1 100,100,1 100,100,1 100,100,1 100,100,1 100,100,1 100,100,1 100,100,1 100,100,1 1000,200,1 1000,200,1 100,100,1 100,100,1 100,100,1 100,100,1 100,100,1 100,100,1 100,100,1 100,100,1 100,100,1 100,100,1 100,100,1 100,100,1 100,100,1 100,100,1 100,100,1 100,100,1 100,100,1 100,100,1 100,100,1 100,100,1 100,100,1 100,100,1 0,000,2 
0,000,2 600,200,2 600,200,2 600,200,2 600,200,2 600,200,2 600,200,2 600,200,2 600,200,2 600,200,2 600,200,2 600,200,2 600,200,2 600,200,2 600,200,2 600,200,2 600,200,2 600,200,2 600,200,2 600,200,2 600,200,2 600,200,2 600,200,2 600,200,2 600,200,2 500,200,1 500,200,1 600,200,2 600,200,2 600,200,2 600,200,2 600,200,2 600,200,2 600,200,2 600,200,2 600,200,2 600,200,2 600,200,2 600,200,2 600,200,2 600,200,2 600,200,2 600,200,2 600,200,2 600,200,2 600,200,2 600,200,2 600,200,2 600,200,2 0,000,2 
0,000,2 800,200,2 800,200,2 800,200,2 800,200,2 800,200,2 800,200,2 800,200,2 800,200,2 800,200,2 800,200,2 800,200,2 800,200,2 800,200,2 800,200,2 800,200,2 800,200,2 800,200,2 800,200,2 800,200,2 800,200,2 800,200,2 800,200,2 800,200,2 800,200,2 500,200,1 500,200,1 800,200,2 800,200,2 800,200,2 800,200,2 800,200,2 800,200,2 800,200,2 800,200,2 800,200,2 800,200,2 800,200,2 800,200,2 800,200,2 800,200,2 800,200,2 800,200,2 800,200,2 800,200,2 800,200,2 800,200,2 800,200,2 800,200,2 0,000,2 
0,000,2 800,200,2 800,200,2 800,200,2 800,200,2 800,200,2 800,200,2 800,200,2 800,200,2 800,200,2 800,200,2 800,200,2 800,200,2 800,200,2 800,200,2 800,200,2 800,200,2 800,200,2 800,200,2 800,200,2 800,200,2 800,200,2 800,200,2 800,200,2 800,200,2 500,200,1 500,200,6 800,200,2 800,200,2 800,200,2 800,200,2 800,200,2 800,200,2 800,200,2 800,200,2 800,200,2 800,200,2 800,200,2 800,200,2 800,200,2 800,200,2 800,200,2 800,200,2 800,200,2 800,200,2 800,200,2 800,200,2 800,200,2 800,200,2 0,000,2 
0,000,2 800,200,2 800,200,2 800,200,2 800,200,2 800,200,2 800,200,2 800,200,2 800,200,2 800,200,2 800,200,2 800,200,2 800,200,2 800,200,2 800,200,2 800,200,2 800,200,2 800,200,2 800,200,2 800,200,2 800,200,2 800,200,2 800,200,2 800,200,2 800,200,2 500,200,1 500,200,1 800,200,2 800,200,2 800,200,2 800,200,2 800,200,2 800,200,2 800,200,2 800,200,2 800,200,2 800,200,2 800,200,2 800,200,2 800,200,2 800,200,2 800,200,2 800,200,2 800,200,2 800,200,2 800,200,2 800,200,2 800,200,2 800,200,2 0,000,2 
0,000,2 800,200,2 800,200,2 800,200,2 800,200,2 800,200,2 800,200,2 800,200,2 800,200,2 800,200,2 800,200,2 800,200,2 800,200,2 800,200,2 800,200,2 800,200,2 800,200,2 800,200,2 800,200,2 800,200,2 800,200,2 800,200,2 800,200,2 800,200,2 800,200,2 500,200,1 500,200,1 800,200,2 800,200,2 800,200,2 800,200,2 800,200,2 800,200,2 800,200,2 800,200,2 800,200,2 800,200,2 800,200,2 800,200,2 800,200,2 800,200,2 800,200,2 800,200,2 800,200,2 800,200,2 800,200,2 800,200,2 800,200,2 800,200,2 0,000,2 
0,000,2 700,100,2 700,100,2 700,100,2 700,100,2 700,100,2 700,100,2 700,100,2 700,100,2 700,100,2 700,100,2 700,100,2 700,100,2 700,100,2 700,100,2 700,100,2 700,100,2 700,100,2 700,100,2 700,100,2 700,100,2 700,100,2 700,100,2 700,100,2 700,100,2 500,200,1 500,200,1 700,100,2 700,100,2 700,100,2 700,100,2 700,100,2 700,100,2 700,100,2 700,100,2 700,100,2 700,100,2 700,100,2 700,100,2 700,100,2 700,100,2 700,100,2 700,100,2 700,100,2 700,100,2 700,100,2 700,100,2 700,100,2 700,100,2 0,000,2 
0,000,2 100,100,1 100,100,1 100,100,1 100,100,1 100,100,1 300,000,2 300,000,2 300,000,2 300,000,2 300,000,2 300,000,2 300,000,2 300,000,2 300,000,2 300,000,2 300,000,2 300,000,2 300,000,2 300,000,2 100,100,1 100,100,1 100,100,1 100,100,1 100,100,1 1000,100,1 1000,100,1 100,100,1 100,100,1 100,100,1 100,100,1 100,100,1 100,100,1 100,100,1 100,100,1 100,100,1 100,100,1 100,100,1 100,100,1 100,100,1 100,100,1 100,100,1 100,100,1 100,100,1 100,100,1 100,100,1 100,100,1 100,100,1 100,100,1 0,000,2 
0,000,2 000,300,1 000,300,1 100,100,1 100,100,1 100,100,1 300,000,2 300,000,2 100,100,1 100,100,1 100,100,1 100,100,1 100,100,1 100,100,1 100,100,1 100,100,1 100,100,1 100,300,2 300,000,2 300,000,2 100,100,1 100,100,1 100,100,1 100,100,1 100,100,1 1000,100,1 1000,100,1 100,100,1 100,100,1 100,100,1 100,100,1 100,100,1 100,100,1 100,100,1 100,100,1 100,100,1 100,100,1 100,100,1 100,100,1 100,100,1 100,100,1 100,100,1 100,100,1 100,100,1 100,100,1 100,100,1 100,100,1 100,100,1 100,100,1 0,000,2 
0,000,2 000,300,1 000,300,1 100,100,1 100,100,1 100,100,1 300,000,2 300,000,2 100,100,1 1000,300,1 100,000,1 100,000,1 100,000,1 100,000,1 100,300,2 100,300,2 200,000,1 200,100,1 300,000,2 300,000,2 100,100,1 100,100,1 100,100,1 100,100,1 100,100,1 1000,100,1 1000,100,1 100,100,1 100,100,1 100,100,1 100,100,1 000,300,1 000,300,1 100,100,1 100,100,1 200,300,2 200,300,2 100,100,1 100,100,1 100,100,1 100,100,1 100,100,1 100,100,1 100,100,1 100,100,1 100,100,1 100,100,1 100,100,1 100,100,1 0,000,2 
0,000,2 100,100,1 100,100,1 100,100,1 100,100,1 100,100,1 300,000,2 300,000,2 000,300,1 000,100,1 000,300,1 000,300,1 100,100,6 100,100,1 100,300,2 100,300,2 200,100,1 200,100,1 300,000,2 300,000,2 100,100,1 100,100,1 100,100,1 100,100,1 100,100,1 1000,100,1 1000,100,1 100,100,1 100,100,1 100,100,1 100,100,1 000,300,1 000,300,1 100,100,1 100,100,1 100,100,1 100,100,1 100,100,1 100,100,1 100,100,1 000,300,1 000,300,1 000,300,1 100,100,1 100,100,1 100,100,1 100,100,1 100,100,1 100,100,1 0,000,2 
0,000,2 100,100,1 200,300,2 100,100,1 100,100,1 100,100,1 300,000,2 300,000,2 000,300,1 000,100,1 000,300,1 000,300,1 100,100,1 100,100,1 100,100,1 100,100,1 200,100,1 200,100,1 300,000,2 300,000,2 100,100,1 100,100,1 100,100,1 100,100,1 100,100,1 1000,100,1 1000,100,1 100,100,1 100,100,1 200,300,2 100,100,1 100,100,1 100,100,1 100,100,1 100,100,1 100,100,1 100,100,1 000,300,1 000,300,1 000,300,1 000,300,1 100,100,1 100,100,1 000,300,1 000,300,1 100,100,1 100,100,1 100,100,1 100,100,1 0,000,2 
0,000,2 100,100,1 100,100,1 100,100,1 100,100,1 100,100,1 300,000,2 300,000,2 000,300,1 000,200,1 100,200,1 100,200,1 100,200,1 100,200,1 100,200,1 100,200,1 200,200,1 200,100,1 300,000,2 300,000,2 100,100,1 100,100,1 100,100,1 100,100,1 100,100,1 1000,100,1 1000,100,1 100,100,1 100,100,1 100,100,1 100,100,1 100,100,1 100,100,1 100,100,26 100,100,1 000,300,1 000,300,1 000,300,1 100,100,1 100,100,1 100,100,1 100,100,1 100,100,1 000,300,1 000,300,6 100,100,26 100,100,1 100,100,1 100,100,1 0,000,2 
0,000,2 100,100,1 100,100,1 100,100,1 100,100,1 100,100,1 300,000,2 300,000,2 100,100,1 100,100,1 100,200,1 100,200,1 000,300,1 000,300,1 000,300,1 100,200,1 100,100,1 100,100,1 300,000,OD2 300,000,2 100,100,1 100,100,1 100,100,1 100,100,1 100,100,1 1000,100,1 1000,100,1 100,100,1 100,100,1 100,100,1 100,100,1 100,100,1 100,100,1 000,300,1 000,300,1 100,100,1 100,100,1 100,100,1 100,100,1 100,100,1 100,100,1 100,100,1 100,100,1 100,100,1 100,100,1 100,100,1 200,300,2 100,100,1 100,100,1 0,000,2 
0,000,2 100,100,1 100,100,1 100,100,1 100,100,1 100,100,1 300,000,2 600,000,2 300,000,2 900,200,1 900,200,1 300,000,2 300,000,2 300,000,2 600,000,2 300,000,2 300,000,2 300,000,2 600,000,2 300,000,2 100,100,1 100,100,1 100,100,1 100,100,1 100,100,1 1000,100,1 1000,100,1 100,100,1 100,100,1 100,100,1 100,100,1 100,100,1 100,100,2 100,100,1 100,100,1 100,100,1 100,100,1 100,100,1 100,100,1 100,100,1 100,100,1 100,100,1 100,100,1 100,100,1 100,100,2 100,100,2 200,300,2 200,300,2 100,100,1 0,000,2 
0,000,2 100,100,1 200,300,2 100,100,1 100,100,1 100,100,1 300,000,2 300,000,2 300,000,2 900,300,1 900,300,1 300,000,2 300,100,14 300,000,2 300,000,2 300,000,2 600,000,2 300,000,2 300,000,2 300,000,2 100,100,1 100,100,1 100,100,1 100,100,1 100,100,1 1000,100,1 1000,100,1 100,100,1 100,100,1 100,100,1 100,100,1 100,100,1 100,100,1 100,100,1 100,100,1 100,100,1 100,100,1 100,100,1 100,100,1 100,100,1 100,100,1 100,100,1 200,300,2 100,100,1 100,100,1 000,300,1 100,100,1 100,100,1 100,100,1 0,000,2 
0,000,2 100,100,1 100,100,1 100,100,1 100,100,1 100,100,1 100,100,1 100,100,1 100,100,1 1000,200,1 1000,200,1 1000,200,1 1000,200,1 1000,200,1 1000,200,1 1000,200,1 1000,200,1 1000,100,1 1000,100,1 1000,100,1 1000,100,1 1000,100,1 1000,100,1 1000,100,1 1000,100,1 1000,100,1 1000,200,1 1000,200,1 1000,200,1 1000,200,1 1000,200,1 1000,200,1 1000,200,1 1000,200,1 1000,200,1 1000,200,1 1000,200,1 1000,200,1 1000,200,1 1000,200,1 100,100,1 100,100,1 100,100,1 100,100,1 100,100,1 000,300,1 100,100,1 100,100,1 100,100,1 0,000,2 
0,000,2 100,100,1 100,100,1 100,100,1 100,100,1 100,100,1 100,100,1 100,100,1 100,100,1 1000,200,1 1000,200,26 1000,200,1 1000,200,1 1000,200,1 1000,200,1 1000,200,1 1000,200,1 1000,100,1 1000,100,1 1000,100,1 1000,100,1 1000,100,1 1000,100,1 1000,100,1 1000,100,1 1000,100,1 1000,200,1 1000,200,1 1000,200,1 1000,200,1 1000,200,1 1000,200,1 1000,200,1 1000,200,1 1000,200,1 1000,200,1 1000,200,1 1000,200,1 1000,200,1 1000,200,1 1000,200,1 100,100,1 100,100,1 100,100,1 100,100,1 100,100,1 100,100,1 100,100,1 100,100,1 0,000,2 
0,000,2 100,100,1 100,100,1 100,100,1 100,100,1 100,100,1 100,100,1 100,100,1 100,100,1 100,100,1 100,100,1 100,100,1 100,100,1 100,100,1 100,100,1 100,100,1 100,100,1 100,100,1 100,100,1 100,100,1 100,100,1 100,100,1 100,100,1 000,300,1 000,300,1 100,100,1 100,100,1 100,100,1 100,100,1 100,100,1 100,100,1 100,100,1 100,100,1 100,100,1 100,100,1 100,100,1 100,100,1 100,100,1 1000,200,1 1000,200,1 1000,200,1 100,100,1 100,100,1 100,100,1 100,100,1 100,100,1 100,100,1 100,100,1 100,100,1 0,000,2 
0,000,2 100,100,1 000,300,1 000,300,1 100,100,1 100,100,1 100,100,1 100,100,1 100,100,1 100,100,1 100,100,1 100,100,1 100,100,1 100,100,1 100,100,1 100,100,1 100,100,1 100,100,1 100,100,1 100,100,1 100,100,1 100,100,1 100,100,1 000,300,1 000,300,1 100,100,1 100,100,1 100,100,1 100,100,1 100,100,1 100,100,1 100,100,1 100,100,1 100,100,1 100,100,1 100,100,1 100,100,1 100,100,1 100,100,1 1000,200,1 1000,200,1 100,100,1 100,100,1 100,100,1 100,100,1 100,100,1 100,100,1 100,100,1 100,100,1 0,000,2 
0,000,2 100,100,1 000,300,1 000,300,1 100,100,1 100,100,1 100,100,1 000,300,1 000,300,1 000,300,1 000,300,1 100,100,1 100,100,1 100,100,1 100,100,1 100,100,1 200,300,2 100,100,1 100,100,1 100,100,1 100,100,1 100,100,1 100,100,1 000,300,1 000,300,1 000,300,1 100,100,1 100,100,1 100,100,1 100,100,1 100,100,1 100,100,1 100,100,1 100,100,1 100,300,2 100,300,2 100,100,1 100,100,1 100,100,1 1000,200,1 1000,200,1 1000,200,1 1000,200,6 1000,200,1 1000,200,1 1000,200,1 1000,200,1 1000,200,1 1000,200,10 0,000,2 
0,000,2 100,100,1 000,300,1 000,300,1 100,100,1 100,100,1 100,100,1 100,100,1 100,100,1 100,100,1 100,100,1 100,100,1 100,100,1 100,100,1 100,100,1 100,100,1 100,100,1 100,100,1 100,100,1 100,100,1 100,100,1 100,100,1 100,100,1 000,300,1 000,300,1 000,300,1 100,100,1 100,100,1 200,300,2 100,100,1 100,100,1 100,100,1 100,100,1 100,100,1 100,300,2 100,300,2 100,100,1 100,100,1 100,100,1 1000,200,1 1000,200,1 1000,200,1 1000,200,1 1000,200,1 1000,200,1 1000,200,1 1000,200,1 1000,200,1 1000,200,10 0,000,2 
0,000,2 100,100,1 100,100,1 100,100,1 100,100,1 100,100,1 100,100,1 100,100,1 100,100,25 100,100,1 100,100,1 100,100,1 100,300,2 100,300,2 100,100,1 100,100,1 100,100,1 100,100,1 100,100,1 100,100,1 100,100,1 100,100,1 100,100,1 100,100,1 000,300,1 000,300,1 100,100,1 100,100,1 100,100,1 100,100,1 100,100,1 100,100,1 100,100,1 100,100,1 100,100,1 100,100,1 100,100,1 100,100,1 100,100,1 100,100,1 100,100,1 100,100,1 100,100,1 100,100,1 100,100,1 100,100,1 100,100,1 100,100,1 100,100,1 0,000,2 
0,000,2 100,100,1 100,100,1 100,100,1 200,300,2 100,100,1 100,100,1 100,100,1 100,100,1 100,100,1 100,100,1 100,100,1 100,300,2 100,300,2 100,100,1 100,100,1 100,100,1 100,100,1 100,100,1 100,100,1 100,100,1 100,100,1 100,100,1 100,100,1 100,100,1 100,100,1 100,100,1 100,100,1 100,100,1 100,100,1 100,100,1 100,100,1 100,100,1 100,100,1 100,100,1 100,100,1 100,100,1 100,100,1 100,100,1 100,100,1 100,100,1 100,100,1 100,100,1 100,100,1 100,100,1 100,100,1 100,100,1 100,100,1 100,100,1 0,000,2 
0,000,2 100,100,1 100,100,1 100,100,1 100,100,1 100,100,1 100,100,1 100,100,1 100,100,1 100,100,1 100,100,1 100,100,1 100,100,1 100,100,1 100,100,1 100,100,1 100,100,1 100,100,1 100,100,1 100,100,1 100,100,1 100,100,1 100,100,1 100,100,1 100,100,1 100,100,1 100,100,1 100,100,1 100,100,1 100,100,1 100,100,1 100,100,1 100,100,1 100,100,1 100,100,1 100,100,6 100,100,1 100,100,1 100,100,1 100,100,1 100,100,1 100,100,1 100,100,1 100,100,1 100,100,1 100,100,1 100,100,1 100,100,1 100,100,1 0,000,2 
0,000,2 100,100,1 100,100,1 100,100,26 100,100,1 100,100,1 100,100,1 100,100,1 100,100,1 100,100,1 100,100,1 100,100,1 100,100,1 100,100,1 100,100,1 100,100,1 100,100,1 100,100,1 100,100,1 100,100,1 100,100,1 200,300,2 100,100,1 100,100,1 100,100,1 100,100,1 100,100,1 100,100,1 100,100,1 100,100,1 100,100,1 100,100,1 100,100,1 100,100,1 100,100,1 100,100,1 100,100,1 100,100,1 100,100,1 100,100,1 100,100,1 200,300,2 100,100,1 100,100,1 100,100,1 100,100,1 100,100,1 100,100,1 100,100,1 0,000,2 
0,000,2 100,100,1 100,100,1 100,100,1 100,100,1 100,100,1 100,100,1 100,100,1 100,100,1 100,100,1 000,300,1 000,300,1 000,300,1 000,300,1 100,100,1 100,100,1 100,100,1 100,100,1 100,100,1 100,100,1 100,100,1 100,100,1 100,100,1 100,100,1 100,100,1 100,100,1 100,100,1 100,100,1 100,100,1 100,100,1 100,100,1 100,100,1 100,100,1 100,300,2 100,300,2 100,100,1 100,100,1 100,100,1 100,100,1 100,100,1 100,100,1 100,100,1 100,100,1 100,100,1 100,100,1 100,100,1 100,100,1 100,100,1 100,100,1 0,000,2 
0,000,2 100,100,1 100,100,1 100,100,1 100,100,1 100,100,1 100,100,1 100,100,1 000,300,1 000,300,1 000,300,1 100,100,1 100,100,1 000,300,1 000,300,1 000,300,1 100,100,1 100,100,1 100,100,1 100,100,1 100,100,1 100,100,1 100,100,1 100,100,1 100,100,1 100,100,1 100,100,1 100,100,1 100,100,1 100,100,1 100,100,1 100,100,1 100,300,2 100,300,2 100,300,2 100,100,1 100,100,1 100,100,1 100,100,1 100,100,1 100,100,1 100,100,1 100,100,1 100,100,1 100,100,1 100,100,1 100,100,1 100,100,1 100,300,2 0,000,2 
0,000,2 100,100,1 100,100,1 100,100,1 100,100,1 100,100,1 100,100,1 100,100,1 100,100,1 100,100,1 100,100,1 100,100,1 100,100,1 100,100,1 100,100,1 000,300,1 000,300,1 000,300,1 000,300,1 000,300,1 100,100,1 100,100,1 100,100,1 100,100,1 100,100,1 100,100,1 100,100,1 100,100,1 100,100,1 100,100,1 100,100,1 100,100,1 100,100,1 100,100,1 100,100,1 100,100,1 100,100,1 100,100,1 100,100,1 100,100,1 100,100,1 100,100,1 100,100,1 100,100,1 100,100,1 100,100,1 100,100,1 100,100,1 100,100,1 0,000,2 
0,000,2 0,000,2 0,000,2 0,000,2 0,000,2 0,000,2 0,000,2 0,000,2 0,000,2 0,000,2 0,000,2 0,000,2 0,000,2 0,000,2 0,000,2 0,000,2 0,000,2 0,000,2 0,000,2 0,000,2 0,000,2 0,000,2 0,000,2 0,000,2 0,000,2 0,000,2 0,000,2 0,000,2 0,000,2 0,000,2 0,000,2 0,000,2 0,000,2 0,000,2 0,000,2 0,000,2 0,000,2 0,000,2 0,000,2 0,000,2 0,000,2 0,000,2 0,000,2 0,000,2 0,000,2 0,000,2 0,000,2 0,000,2 0,000,2 0,000,2 
