23 22
200,000,1 200,000,1 200,000,1 200,000,1 200,000,1 200,000,1 200,000,1 200,000,1 200,000,1 200,000,1 200,000,2 200,000,2 200,000,2 200,000,1 200,000,1 200,000,1 200,000,1 200,000,1 200,000,1 200,000,1 200,000,1 200,000,1 200,000,1 
200,000,1 200,000,1 200,000,1 200,000,1 200,000,1 200,000,1 200,000,1 200,000,1 200,000,1 200,000,2 200,000,2 1400,000,1 200,000,2 200,000,2 200,000,1 200,000,1 200,000,1 200,000,1 200,000,1 200,000,1 200,000,1 200,000,1 200,000,1 
200,000,1 200,000,1 200,000,1 200,000,1 200,000,1 200,000,1 200,000,1 200,000,1 200,000,2 200,000,2 500,000,1 100,000,1 600,000,1 200,000,2 200,000,2 200,000,1 200,000,1 200,000,1 200,000,1 200,000,1 200,000,1 200,000,1 200,000,1 
200,000,1 200,000,1 200,000,1 200,000,1 200,000,1 200,000,1 200,000,1 200,000,2 200,000,2 500,000,1 100,000,1 1500,000,7 100,000,1 600,000,1 200,000,2 200,000,2 200,000,1 200,000,1 200,000,1 200,000,1 200,000,1 200,000,1 200,000,1 
200,000,1 200,000,1 200,000,1 200,000,1 200,000,1 200,000,1 200,000,1 200,000,2 1100,000,1 900,000,1 100,000,1 100,000,1 100,000,1 900,000,1 1200,000,0 200,000,2 200,000,1 200,000,1 200,000,1 200,000,1 200,000,1 200,000,1 200,000,1 
200,000,1 200,000,1 200,000,1 200,000,1 200,000,1 200,000,1 200,000,1 200,000,2 200,000,2 200,000,2 300,000,1 100,000,1 400,000,1 200,000,2 200,000,2 200,000,2 200,000,1 200,000,1 200,000,1 200,000,1 200,000,1 200,000,1 200,000,1 
200,000,1 200,000,1 200,000,1 200,000,2 200,000,2 200,000,2 200,000,1 200,000,1 200,000,1 200,000,2 300,000,1 100,000,1 400,000,1 200,000,2 200,000,1 200,000,1 200,000,1 200,000,2 200,000,2 200,000,2 200,000,1 200,000,1 200,000,1 
200,000,1 200,000,1 200,000,2 200,000,2 1400,000,1 200,000,2 200,000,2 200,000,1 200,000,1 200,000,2 300,000,1 100,000,1 400,000,1 200,000,2 200,000,1 200,000,1 200,000,2 200,000,2 1400,000,1 200,000,2 200,000,2 200,000,1 200,000,1 
200,000,1 200,000,2 200,000,2 500,000,1 100,000,1 600,000,1 200,000,2 200,000,2 200,000,2 200,000,2 300,000,1 100,000,1 400,000,1 200,000,2 200,000,2 200,000,2 200,000,2 500,000,1 100,000,1 600,000,1 200,000,2 200,000,2 200,000,1 
200,000,2 200,000,2 500,000,1 100,000,1 100,000,1 100,000,1 1000,000,1 1000,000,1 1000,000,1 1000,000,1 100,000,1 100,000,1 100,000,1 1000,000,1 1000,000,1 1000,000,1 1000,000,1 100,000,1 100,000,1 100,000,1 600,000,1 200,000,2 200,000,2 
200,000,2 1100,000,1 100,000,1 100,000,1 1600,000,23 100,000,1 100,000,1 100,000,1 100,000,1 100,000,24 100,000,0 100,000,1 100,000,1 100,000,1 100,000,1 100,000,1 100,000,1 100,000,1 1700,000,3 100,000,1 100,000,1 1200,000,1 200,000,2 
200,000,2 200,000,2 700,000,1 100,000,1 100,000,1 100,000,1 900,000,1 900,000,1 900,000,1 900,000,1 100,000,1 100,000,1 100,000,1 900,000,1 900,000,1 900,000,1 900,000,1 100,000,1 100,000,1 100,000,1 800,000,1 200,000,2 200,000,2 
200,000,1 200,000,2 200,000,2 700,000,1 100,000,1 800,000,1 200,000,2 200,000,2 200,000,2 200,000,2 300,000,1 100,000,1 400,000,1 200,000,2 200,000,2 200,000,2 200,000,2 700,000,1 100,000,1 800,000,1 200,000,2 200,000,2 200,000,1 
200,000,1 200,000,1 200,000,2 200,000,2 1300,000,1 200,000,2 200,000,2 200,000,1 200,000,1 200,000,2 300,000,1 100,000,1 400,000,1 200,000,2 200,000,1 200,000,1 200,000,2 200,000,2 1300,000,1 200,000,2 200,000,2 200,000,1 200,000,1 
200,000,1 200,000,1 200,000,1 200,000,2 200,000,2 200,000,2 200,000,1 200,000,1 200,000,1 200,000,2 300,000,1 100,000,1 400,000,1 200,000,2 200,000,1 200,000,1 200,000,1 200,000,2 200,000,2 200,000,2 200,000,1 200,000,1 200,000,1 
200,000,1 200,000,1 200,000,1 200,000,1 200,000,1 200,000,1 200,000,1 200,000,1 200,000,2 200,000,2 300,000,1 100,000,1 400,000,1 200,000,2 200,000,2 200,000,1 200,000,1 200,000,1 200,000,1 200,000,1 200,000,1 200,000,1 200,000,1 
200,000,1 200,000,1 200,000,1 200,000,1 200,000,1 200,000,1 200,000,1 200,000,2 200,000,2 500,000,1 100,000,1 100,000,1 100,000,1 600,000,1 200,000,2 200,000,2 200,000,1 200,000,1 200,000,1 200,000,1 200,000,1 200,000,1 200,000,1 
200,000,1 200,000,1 200,000,1 200,000,1 200,000,1 200,000,1 200,000,1 200,000,2 1100,000,1 900,000,1 900,000,1 900,000,1 900,000,1 900,000,1 1200,000,1 200,000,2 200,000,1 200,000,1 200,000,1 200,000,1 200,000,1 200,000,1 200,000,1 
200,000,1 200,000,1 200,000,1 200,000,1 200,000,1 200,000,1 200,000,1 200,000,2 200,000,2 200,000,2 200,000,2 200,000,2 200,000,2 200,000,2 200,000,2 200,000,2 200,000,1 200,000,1 200,000,1 200,000,1 200,000,1 200,000,1 200,000,1 
200,000,1 200,000,1 200,000,1 200,000,1 200,000,1 200,000,1 200,000,1 200,000,1 200,000,1 200,000,1 200,000,1 200,000,1 200,000,1 200,000,1 200,000,1 200,000,1 200,000,1 200,000,1 200,000,1 200,000,1 200,000,1 200,000,1 200,000,1 
200,000,1 200,000,1 200,000,1 200,000,1 200,000,1 200,000,1 200,000,1 200,000,1 200,000,1 200,000,1 200,000,1 200,000,1 200,000,1 200,000,1 200,000,1 200,000,1 200,000,1 200,000,1 200,000,1 200,000,1 200,000,1 200,000,1 200,000,1 
200,000,1 200,000,1 200,000,1 200,000,1 200,000,1 200,000,1 200,000,1 200,000,1 200,000,1 200,000,1 200,000,1 200,000,1 200,000,1 200,000,1 200,000,1 200,000,1 200,000,1 200,000,1 200,000,1 200,000,1 200,000,1 200,000,1 200,000,1 
