*X*******X
*XXX*XXX*X
***X***X**
XX*XXXXX*X
***X****XX
*XXX*XXX**
*X***X***X
*X*XXX*XXX
***X*****X
XX*XX*XX**