######
#    ###
# ##XX #
# #  # #
#    # #
# #    # 
#O     #
#O P####
#####   
