########
#O PX  #
#      #
# O X  #
#O   X #
########
