##########
#     P  #
#        #
#  XO  ###
#        #
# OX     #
##########
